0000000000
000000000
0010010100
0000101000
0010000000
0000001000
0011000100
0000000010
0100101000
0000000000